[SH7_ActionZone]
Abbreviations=Abbreviations
ambush=Hiding place
back2body=Examine corpse
Bird house=Bird house
blade=Blade
blood=Blood
Bottle=Bottle
cabintable=Table
Cameo=Cameo
Catholic rosary=Catholic rosary
check boots=Compare footprint
compass=Navigation tools
Crestet tit=Crested tit
dead_peter=Dead Peter Carey
dirtyglass=Dirty glass
Dundee=Dundee
emptyplace=Outline in the dust
Field=Garden
Flap=Flap
floor_zoomer=Wooden floor
footprint=Footprint
footprints=Footprints
Gardening gloves=Gardening gloves
Gate=Gate
Hammerfest=Hammerfest
Handle=Wooden handle
harpoon=Harpoon
harpoonstand=Harpoon rack
Initials=Initials
inscription=Inscription
judith=Mrs. Carey
Knife=Sea knife
lock_box=Small wooden box
Map=Map
Note=Notebook
notebook=Notebook
odejda_pitera=Peter Carey's clothes
oldboots=Peter Carey's boots
pendant=Bunch of letters
peter_face=Peter Carey's face
Picture=Ship's nameplate
pierced_chest=Pierced chest
plank=Ill-fitting plank
Pool of blood=Pool of blood
pool_zoomer=Pool of blood
pouch=Tobacco pouch
Scratches=Scratches
seachest=Wooden chest
shelf_zoomer=Shelf
shiplogs=Ship's logs
squale_tooth=Sperm whale tooth
SV_devoted_place=Suspiciously empty space
SV_door=Door
SV_doorlock=Door lock
SV_floor=Shed's floor
SV_illfitting_plank=Ill-fitting plank
SV_outline=Outline in the dust
SV_scratches=Scratches
SV_shelf=Shelf
SV_wooden_planks=Wooden planks
tachka=Wheelbarrow
Tobacco=Tobacco
window=Window
zoom_box=Small chest
zoomer_chest=Chest contents
SV_pathway=Stone pathway
SV_Land=Land around stone pathway
SV_Footprints=Footprints
TobaccoLeaf=Tobacco Leaf
SmokingPipe=Smoking Pipe
Check_boots=Check boots

