[SH7_ActionZone]
Gate=Gate
Gong=Gong
door=Door
Guru=Guru
COGTatu=Tattoo
COGInjury2=Palm injury
COGInjury3=Acid burn
COGInjury=Chemical practice
COGThickCallouses=Fingertip calluses
BrokenPot=Pot piece
Cover=Cover
Pots=Flower pots
Pot=Pot
brand=Brand
Flyer=Benefactors
DrugsTable=Drugs table
Spoon=Spoon
Trewan=Trewan
Adept=Adept
Cage=Cage
CageDoor=Cage door
CageWithCaterpillars=Cage with caterpillars
Caterpillars=Caterpillars
DionaeaMuscipula=Dionaea Muscipula
RafflesiaArnoldii=Rafflesia Arnoldii
AdeniumBonsai=Adenium Bonsai
FlowerCage=Flower Cage
DionaeaCarnivorus=Dionaea Carnivorus
FloremDiabolica=Florem Diabolica
CarlinaInebriare=Carlina Inebriare
AlismaGigantica=Alisma Gigantica
OmphalotuflosPetalius=Omphalotuflos Petalius
TropicalPlant=Tropical plant
PlateForSmokeOpium=Plate for opium smoking
OpiumBalls=Opium balls
TableExperiment=Table for experiments
ChimistCupboard=Chemistry cupboard
ChimistBottles=Chemistry bottles
ChimistBottle=Chemistry bottle
White=Miss White
BrokenPots=Broken pieces
SomethingHidden=Something hidden
TakePot=Flower pot

