[SH7_ActionZone]
speak_tobby=Toby
door=Door
newsPaper=Table
take_up=Newspaper
fingerprint=Scratches
Picture=Picture
Safe=Safe
etc=Medical report
money=Money
coins=Coins
Photo=Small table
Photo_up=Photograph
Miss Fraser=Two women
clap=Fastener
plashka=Backing board
Text=Writing
Teresa=Theresa
Lady=Lady Brackenstall
Inspector=Inspector Lestrade
Candle=Candlestick
Poker=Poker
Body=Body
Foot=Feet
Cord=Piece of rope
cord_zoom=Bell rope
Chair knot=Piece of rope
Chair=Chair
wine=Wine bottle
Empty=Empty cell
Glasses=Glasses
glass_up=Glass
Bottle=Bottle
French window=French window
Gate=Gate
Instrument box=Tool box
Hook=Hook
hook_on_chain=Chain
Bags=Bags
Trunk=Suitcase
Wheel=Windlass
Bucket=Bucket
Gerb=Coat-of-arms
paket=Glittering object
Fork=Fork
Clothe=Bag
Sideboard=Sideboard
at the shed=Shed
at the well=Well
well_down=Inside well
near the wall=Wall
decanter=Decanter
silverware_box=Silverware box
stick=Stick
kamin=Fireplace grate
Head body=Head
head=Head wound
chain=Chain
COOld_Bruisings=Old bruises
COFresh_Bruisings=Fresh bruises
COGolden_Brooch2=Gold brooch
COGolden_Brooch3=Kangaroo and Emu
COGolden_Brooch=Australian origin
COWedding_Ring=Wedding ring
CONeat_Hands=Neat hands
COPale_Cheeks=Pale cheeks
COElegant_dressing=Elegant dress
COface_wrinlkes=Wrinkles
COWorking_hands=Working hands
COcoffee_stain=Coffee stain
COHandkerfchief2=Handkerchief
COHandkerfchief3=Vinegar smell
COHandkerfchief4=Resuscitation
COHandkerfchief=Caring
Weapon=Hunting rifles
Glass=Glass
Open=Open
OpenWell=Well
cut bellrope=Cut bellrope
mantelpiece=Mantelpiece
bellrope piece=Bellrope piece
Validate=Turn handle

