[SH7_ActionZone]
Sherlock=Sherlock
Watson=Watson
Desk=Desk
Box=Box
Shelves=Shelves
Reftable=Table
Mold=Mould
Pit=Pit
rope=Ropes
Bridge=Bridge
Tools=Archaeological tools
fresco=Fresco
Cyclop=Cyclops
Vulcan=Vulcan
Minerva=Minerva
Neptune=Neptune
parts=Metal cubes
Part of crossbow=Part of crossbow
Covered fresco=Wall
Hook=Hooks
Crossbow=Crossbow
ring=Iron ring
Tab=Restricted access
Picture=Schematic
board=Board
Gastra=Dismounted device
something=Hidden place
wicket=Wicket
Document=Document
Bull=Bull
Floor=Floor
Shelf=Shelf
railway=Railway
Bow=Bow
Handle=Handle
Shutter=Shutter
Mechanism=Mechanism
Place_for_Bow=Bow rabbet
Place_for_Handle=Handle joint
Place_for_Shutter=Shutter groove
Place_for_Mechanism=Mechanism housing
frigidarium=Frigidarium
Gastraphetes=Gastraphetes

