[SH7_ActionZone]
Archives=Portable archives
Ashtray=Ashtray
Cab=Cab
Cigar=Cigar stub
Coal_stove=Teapot
COMexCloth=Smart clothes
COMexAge=Wrinkles
COMexBuild=Strong build
COMexCigar=Expensive cigar
COMexHand2=Coarse skin
COMexHand3=Bruised hands
COMexHand=Martial arts
COMasDWatch=No watch
COMasDButton=Missing button
COMasDRing=Ring mark
COMasDSad=Melancholy
Doncaster_Staionmaster=Doncaster Station Master
Flag=Flag
HMagazin=Horse racing magazines
mexican=Mysterious man
Smell_Cigar=Sniff cigar
Tele=Telegraph
WifeLetter=A letter to wife
LawyerLetter=A letter to lawyer
SmellCigar=Cigar stub
rails=Rails
Switch=Rail switch
EndRails=End of the rails
Post=Postal bags
traincomposition=Train composition
ChiefBag=Station master's bag
BRNpaper=Piece of burnt paper
tableDon=Office table
Tickets=Betting ticket
HorsrideTickes=Horse racing tickets
Text=Text
MintLeafs=Mint leaves
CigarSmoke=Cigar smoke

