[SH7_ActionZone]
Sherlock=Sherlock
Watson=Watson
Policeman=Policeman
Pitkin=Mr. Pitkin
Garrow=Mr. Garrow
Blinkhorn=Mr. Blinkhorn
azdoor=Door
Box=Box
Map=Map
azring=Ring
Fountain Pen=Fountain pen
Roman Coin=Coin
notebook=Notebook
writting=Notebook
torn pages=Torn pages
Body=Body
Wound=Wound
hair=Hair
Arm=Arm
Chest=Chest scar
bruise=Bruised back
Turn body=Turn body
Belly=Stomach scar
Turn=Turn
Scars=Scars
Visit card=Visiting card
Handkerchief=Handkerchief
paper pen=Pencil
Broken glasses=Broken glasses
Pitkin's belongings=Pitkin's belongings
phial of Drug=Drug phial
Blody towel=Bloody towel
Garrow's belongings=Garrow's belongings
Blinkhorn's belongings=Blinkhorn's belongings
Letter from pitkin=Letter from Pitkin
sir Rodney's belongins=Bentcliffe's belongings
Thin=Thin
Beard=Beard
Field clothes=Field clothes
Callosity=Callus
Shaking hands=Shaking hands
Symbol=Old symbol
Simple clothes=Simple clothes
bruise2=Bruised shoulders
Disdain=Disdain
Age=Age
Neat Hands=Neat Hands
Nice Suit=Smart suit
Badly shaved=Badly shaven
Eye-sacks=Eye bags
Dirty clothes=Dirty clothes
Hamsa Hand=Protective Amulet
Superstitious=Hamsa Hand
Protecting Amulet=Superstitious
Perspiration=Perspiration
Fresh dirt stain=Fresh dirt stain
Recent earthwork=Recent earthwork
Rusty suspenders=Rusty bracers
Shabby workwear=Shabby workwear
Not wealthy=Not wealthy
Focused look=Focused look
Attentive=Attentive
Arrogant look=Arrogant look
Mouth shape=Mouth shape
Signet ring=Signet ring
Aristocratic roots=Aristocratic roots
Golden chain=Gold chain
Kashmir waistcoat=Cashmere waistcoat
Man of wealth=Man of wealth

