[SH7_ActionZone]
Archives=Portable archives
COMastBClothes=Clean clothes
COMastBAge=Young age
COMastBInstructions=Instructions
COMastBFinger=Ink smudges
COPassTicket=Cheap ticket
COPassRing=Married
COPassHand=Rough skin
COPassClothe=Workclothes
COAustralianHat=Australian hat
COAustralian Brooch=Australian brooch
COAustralianWatch=Heavy gold ring
COAustralianClothes=Expensive clothes
ReachPassenger=Rich passenger
Australian=Mr. Robinson
NervousPassenger=Angry passenger
Brigbord_Stationmaster=Bridlington Station Master
Contracts=Contracts
RobinLugagge=Robinson's luggage
Tele=Telegraph
traincomposition=Train composition
Cab=Cab
Post=Postal bags
writetypper=Fresh letter
letterD=Letter
MD_Floor=Gap in the floor
MD_SheetOfPaper=Sheet of paper
Paper=Document
bagRob=Robinson's luggage
labelRob=Robinson's luggage
Papers=Business papers
COAustralianShoes=Fancy shoes
COAustralianShoes2=Crocodile skin
COAustralianShoes3=Australian origin
COAustralianPin=Diamond tie pin
UnderTable=Interstice

