[SH7_ActionZone]
advert=Fishing advertisement
Archives=Portable archives
Wheel=Wheels
plate=Wooden plank
newsPaper=Newspaper
SmallWheel=Small wheel
COMastCSleeve=Red nose
COMastCRing=Married
COMastCClothes=Clean clothes
COMastCFlask=Alcohol flask
COMastCPocket=Fishing line
CSM=Chesterfield Station Master
FT=Fake train
Instruments=Instruments
passagers=Passengers
Cab=Cab
Post=Postal bags
Platform=Handcar wheelbase
Tele=Telegraph
Pole=Pole
Sack=Sack
tracks_wagon=Traces
BottlesSackC=Bottles
traincomposition=Train composition
DM_Floor=Floor
DM_HugeScratches=Scratches
bottleC=Waste bin
morze=Morse code alphabet
zoomCab=Railway handcar
zoomLight=Train spare parts
Headlight=Headlight with dynamo machine
Steam_whistle=Train steam whistle
zoomExting=Fire extinguisher
Extinguisher=Fire extinguisher
zoomPole=Long pole
BRNpapper=Burnt paper
Lever=Handcar lever
UnderTable=Interstice
TakeWoodenBoard=Wooden board
TakeWheel=Wheel
TakeLamp=Lamp
TakeBreak=Brakes
TakeHandMechanism=Hand mechanism
TakePole=Pole
TakeSmallWheel=Small gear
PutWheel=Wheel axle
PutWoddenboard=Wooden base
PutSmallWheel=Small gear housing
PutHandMechanism=Hand mechanism joint
PutBreak=Breaks joint

