[SH7_ActionZone]
Sherlock=Sherlock
Watson=Watson
door=Door
letter=Letter
material for development=Photographic chemicals
development=Photographic development
Analysis Table=Analysis table
microscope=Microscope
peroxyde oxygen=Hydrogen peroxide
nitric acid=Nitric acid
water etc...=Water
silver workshop=Silver experiment
ice workshop=Ice experiment
making Mold=Combine the cubes
Letters=Letters
Map=Map
encyclopedias=Encyclopedias
newspapers=Newspapers
researches=Research
wardrobe=Wardrobe
Make-up table=Make-up table
Acid=Acid
archaeologist=Archaeologist
Blood sample=Blood sample
Ice Cream Maker=Ice-cream maker
Ice Brick=Ice brick
Drop peroxide1=Blood sample
Gas burner=Gas burner
Ice=Ice
icecream=Ice-cream
inscription=Inscription
Knife=Knife
Knife from mold=Cast
Saucepan=Saucepan
Melted silver=Melted silver
Metal piece=Metal piece
Metal sample=Metal sample
Metal stick=Ice pick
Mold=Mould
Part=Mould part
Pipette=Pipette
Place=White London clay
pyramids=Pyramids
Pyrite=Pyrite
rodney=Rodney Bentcliffe
Salt=Salt
Sample under lupa=Blood
Selenite=Selenite
Silver coin=Silver coin
Spoon=Spoon
Plaster solution=Plaster solution
Water=Water
White_clay_particle=White clay particles
Forehead=Forehead
Pupil=Pupil
Chest=Chest
Wrist=Wrist
Silver piece=Silver piece
SwapPieces=Swap pieces
Peroxide=Peroxide
Dirt sample=Dirt sample
Melting pot=Melting pot

