[SH7_ActionZone]
Sherlock=Sherlock
Watson=Watson
door=Door
Policeman=Policeman
Phillips=Mr. Phillips
Inspector=Inspector Lestrade
Pitkin=Mr. Pitkin
Garrow=Mr. Garrow
Blinkhorn=Mr. Blinkhorn
Bottle of champagne=Champagne bottle
Cork=Cork
Water=Melted Ice
brand=Wine label
blood=Blood
Wound=Wound
Face=Face
Right hand=Right hand
Wrist=Wrist
middle finger=Ring finger
blood tarce=Blood traces
Brazier=Brazier
Smelted silver=Melted metal
Glasses=Glasses
crack glass=Crack
Corner shelves=Shelves
Latter=Letter
Map=Map
Fallen Blocks=Fallen blocks
To tunnel=Rope
statue=Statue
earth under nail=Dirt
Key=Key
Blood on towel=Blood on towel
Apodetarium=Apodyterium
Switcher for steam=Steam switch
Tepidarium=Sudatorium
Blinkhor's cloth=Clothes
Rodney's cloth=Clothes
Garrow's cloth=Clothes
Pitkin's cloth=Clothes
Body=Body
frigidarium=Frigidarium
Sir Rodney Docs=Archaeological findings
wreath=Wreath
Scorpion=Scorpion
One eyed face=One eyed face
Trident=Trident
Helmet=Helmet
ship=Ship
Jug=Jug
azspider=Spider
wings=Caduceus
Age=Light wrinkles
telegram=Telegram sent today
Clean costume=Clean suit
Hands=Neat hands
Brooch=Manchester City
Myopia=Thick glass
Tongs=Tongs
Missing Plate=Missing plate
Photo Plate=Glass plate negative
Testimonies=Box
table=Table
Doc=Document
Tab=Builder's plate
Tools=Archaeological tools
photobox=Box
engraving=Sunken relief
newsPaper=Newspaper
Dust=Dust
Scratches=Scratches
Bust=Bust
plaque=Perforated plate
M_top=Document
boffice=Sir Rodney Bentcliffe's office
Grid=Grid
Symbol=Symbol
Shining buttons=Shiny buttons
Starched collar=Starched collar
Pedantic=Fastidious
Scissor cut=Scissor cut
Shears himself=Grooms himself
Lives alone=Lives alone
Figure=Figure

